R 800 600

NO ./text2.xpm
SO ./text1.xpm
WE ./text3.xpm
EA ./text4.xpm
S ./sprite.xpm

F 45,129,106
C 62,115,185   

            1111 11111111111
            1111 10000000001
            1001111110000001
            111001000000111111
            1111111001000011
            1001000100000001
          11110001000111111
111111111111N0002100011
100100010222222200100111
1001000000000000000010111
100100000000000000001001
10010001212121212100101
100100011111111111001001
100000011111200000000001
10010001    110100001111
11111111    1111111111
