R 800 600

NO ./text2.xpm
SO ./text1.xpm
WE ./text3.xpm
EA ./text4.xpm
S ./sprite.xpm

F 45,129,106     
C 62,115,185   

11111111111111
1200000E000021
10111010111101
10120012120001
10101210101001
12101010201001
10111011111001
10100200000201
10101111111111  
10100000000021       
12000000002021 
10000000000021     
11111111111111
