R 800 600

NO ./text2.xpm
SO ./text1.xpm
WE ./text3.xpm
EA ./text4.xpm
S ./sprite.xpm

F 45,129,106     
C 62,115,185   

111111111111111
1000000E0000001
1000000000000101
01111000000001001
    100000000011111   
    11111222000000111        
111100000000001111  
12121212121211      
111111111111111
