R 800 600

NO ./text1.xpm
SO ./text2.xpm
WE ./text3.xpm
EA ./text4.xpm
S ./sprite.xpm

F 45,129,106
C 62,115,185  

111111111111111111111111
111000000000000000000001
100111111000000011111001
100100000000000000001001
100100000000000000000101
100100010000000001001001
100100010000000001001001
1000100100000N0000000101
10010001001011101000111
100100010000000000100111
10010001121212121001001
100100012121212121001001
100100011111111111001001
100100000110001100001001
100000000000200000000001
100100000110001100001001
111111111111111111111111

