R 800 0000600

NO ./text2.xpm
SO ./text1.xpm     
WE ./text3.xpm       
EA ./text4.xpm         
S ./sprite.xpm

F 45,129,106  
C 62,115,185 
 
1111111111111111111
1200000000002000001
1000000000000000001
1001001001001111001
1001200001201200001
1001001201000000001   
1201001001002001001
1001111001111111001
1000002000002000001
1000000000000001111
1111111111111000001
1001000000000000001
1200000000020000001
1000000000002000001
100E000000000200001
1000000000000020001
1000000000000002001
1000000000000000201
1000012121212100001
1111111111111111111