R 800 600

NO ./text2.xpm
SO ./text1.xpm
WE ./text3.xpm
EA ./text4.xpm
S ./sprite.xpm

F 45,129,106
C 62,115,185   

            1111111111111111
            1110000000000001
            1001111110000001
            111001000000111111
            1111111001000011
            1001000100000001
            1001000100011111
1111111111111N000210001
100100010222222200100111
10010000000000000000101
100100000000000000001001
100100012121212121001001
100100011111111111001001
100000011101200000000001
10010001    110100001111
11111111   111111111111
