R 800 600

NO ./text2.xpm
SO ./text1.xpm
WE ./text3.xpm
EA ./text4.xpm
S ./sprite.xpm

F 45,129,106     
C 62,115,185   

11111111111111  
1000000E000001               11111111
10000002000001               10000001
10000011000001               10000001
10000000000001               10000001
100000000000001               11111111  
10000100100001
10001000010001
10010000001001  
10102020202101       
10000000000001 
10202020202021     
11111111111111
