R 800 600

NO ./text1.xpm
SO ./text2.xpm
WE ./text3.xpm
EA ./text4.xpm
S ./sprite.xpm

F 45,129,106
C 62,115,185  

111111111111111111111111
111000000000000000000001
100111111000N00011111001
100100000000000000001001
100100000002220000000101
100100010000000001001001
100100010000000001001001
100010010000000000000101
100100010012100001001001
100100010011100001001001
100100010000000001001001
100100012121212121001001
100100011111111111001001
100100000110001100001001
100000000000200000000001
100100000110001100001001
111111111111111111111111

