R 800 600

NO ./text2.xpm
SO ./text1.xpm
WE ./text3.xpm
EA ./text4.xpm
S ./sprite.xpm

F 45,129,106     
C 62,115,185   

11111111111111  
1000000E000001               11111111
10000000000001               10000001
10000000000001               10000001
10000000000001               10000001
100000000000001               11111111  
10000000000001
10000000000001
10010000001001  
10100000000101       
10000000000001 
11212121212121     
11111111111111
