R 800 600

NO ./text2.xpm
SO ./text1.xpm
WE ./text3.xpm
EA ./text4.xpm
S ./sprite.xpm

F 45,129,106     
C 62,115,185   

111111111111111
1000000E0000001
10000000000001 1
1000000000001 1
100000000000011   
1000002220000001        
100000000000001  
12121212121211      
111111111111111
