R 800 600

NO ./text2.xpm
SO ./text1.xpm
WE ./text3.xpm
EA ./text4.xpm
S ./sprite.xpm

F 45,129,106     
C 62,115,185   

111111111111111
1000000E0000001
10000001000001 1 
1111111 1111111
 
 
111111   11111
100000111000001   
1000002220000001        
100000000000001  
12121212121211      
111111111111111
