R 800 600

NO ./text2.xpm
SO ./text1.xpm
WE ./text3.xpm
EA ./text4.xpm
S ./sprite.xpm

F 45,129,106
C 62,115,185   

111111111111111
1000000E0000001
100000000000001
100000020000001
100000222000001
100000000000001
121212121212121
111111111111111
