R "800 600"
NO ./text1.xpm
SO ./text2.xpm
WE ./text3.xpm
EA ./text4.xpm

S ./sprite.xpm
F 45,129,106
C 62,115,185

11111
00E00
11111
