R 2000 2000
NO ./text1.xpm
SO ./text2.xpm
WE ./text3.xpm
EA ./text4.xpm

S ./sprite.xpm
F 45,129,106
C 62,115,185

111111111111110000111111
100000000000000000000001
100000000000N00000111001
100000000000022000121001
100000000000000000001001
100000000222200000000001
100000000000000000011001
10110011000002000021001
101000010000002000011001
101000010010000200000001
101111110000000020000001
100000000000000000000001
111101111110111111011111
100101000000000000000001
100101000011111000000001
100101000000001000010001
100101000010001000100001
100101010010001000000001
100000010011111000000001
111111110000000000000001
100000000011111000111001
100111000000000000100001
100110000111111111000011
100100000000000000000001
100000000000000000000001
111111100011100011100011
100000100010000000100001
101111111110011000100001
100010001000011001000011
101010101011011000100001
101000100011000000000001
111111111111111111111111
